000000000000000000000000000000000000000000000000000000000000000000000000000
000000000000000000000000000000000000000000000000000000000000000000000000000
000000000000000000000000000000000000000000000000000000000000000000000000000
000000000000000000000000000000000000000000000000000000000000000000000000000
000000000000000000000000000000000000000000000000000000000000000000000000000
000000000000000000000000000000000000000000000000001111111111111111111100000
000000000000000000000000000000000000000000000000001111111111111111111100000
000000000000000000000000000000000000000000000000001111111111111111111100000
000000000000000000000000000000000000000000000000001111111111111111111100000
000000000000000000000000000000000000000000000000001111111111111111111100000
000000000000000000000000000000000000000000000000001111111111111111111100000
000000000000000000000000000000000000000000000000001111111111111111111100000
000000000000000000000000000000000000000000000000001111111111111111111100000
000000000000000000000000000000000000000000000000001111111111111111111100000
000000000000000000000000000000000000000000000000001111111111111111111100000
000000000000000000000000000000000000000000000000001111111111111111111100000
000000000000000000000000000000000000000000000000001111111111111111111100000
000000000000000000000000000000000000000000000000001111111111111111111100000
000000000000000000000000000000000000000000000000001111111111111111111100000
000000000000000000000000000000000000000000000000001111111111111111111100000
000000000000000000000000000000111111111111111000001111111111111111111100000
000000000000000000000000000000111111111111111000001111111111111111111100000
000000000000000000000000000000111111111111111000001111111111111111111100000
000000000000000000000000000000111111111111111000001111111111111111111100000
000000000000000000000000000000111111111111111000001111111111111111111100000
000001111111111111111111100000111111111111111000000000000000000000000000000
000001111111111111111111100000111111111111111000000000000000000000000000000
000001111111111111111111100000111111111111111000000000000000000000000000000
000001111111111111111111100000111111111111111000000000000000000000000000000
000001111111111111111111100000111111111111111000000000000000000000000000000
000001111111111111111111100000000000000000000000000000000000000000000000000
000001111111111111111111100000000000000000000000000000000000000000000000000
000001111111111111111111100000000000000000000000000000000000000000000000000
000001111111111111111111100000000000000000000000000000000000000000000000000
000001111111111111111111100000000000000000000000000000000000000000000000000
000001111111111111111111100000000000000000000000000000000000000000000000000
000001111111111111111111100000000000000000000000000000000000000000000000000
000001111111111111111111100000000000000000000000000000000000000000000000000
000001111111111111111111100000000000000000000000000000000000000000000000000
000001111111111111111111100000000000000000000000000000000000000000000000000
000001111111111111111111100000000000000000000000000000000000000000000000000
000001111111111111111111100000000000000000000000000000000000000000000000000
000001111111111111111111100000000000000000000000000000000000000000000000000
000001111111111111111111100000000000000000000000000000000000000000000000000
000001111111111111111111100000000000000000000000000000000000000000000000000
000000000000000000000000000000000000000000000000000000000000000000000000000
000000000000000000000000000000000000000000000000000000000000000000000000000
000000000000000000000000000000000000000000000000000000000000000000000000000
000000000000000000000000000000000000000000000000000000000000000000000000000
000000000000000000000000000000000000000000000000000000000000000000000000000